101010101
0
000000001
0
101010101
0
100000000
0
101010101
0
000000001
0
000010101
0
000010000
0
001010100
0
001000100
0
001010100
0
000030000